5 6
#####
#...#
#.XG#
P..C#
#...#
#####